50.ox
.o...o....o...................oo.oo.....
...o........o....o.....o......o.........
.o...........o.........o...oo.........o.
.....oo...............o....oo...........
.o.o.....o..oo...o........o.o...o....oo.
......o..........o.............o.......o
...o............o........o.......o.oo...
ooo....o.oo.oo.......o.......o..o......o
..o.....o...o...o.oo...........o.o.o....
.o.......o.oo........o.oo.............oo
oo........o.............o.........o.oo..
....o....o....o.o.oo....o..............o
..oo..o.o.......oooo..o..o....o.....o...
..o...o....o.........o....o..o.o....o..o
o...o..........................o...o.o..
....o....o.......o....o.o.........o.....
.o.....o......................o..o......
ooo..o.o...o.o.o..oo......o.....ooo.....
....o..............ooo...o......o..o....
.......o..o.........o....o..oo.......o..
.o..o.......o..oo......o.....o.....oo...
o.o....o.oo.ooo..........o..oo..oo..o...
....o....o.o.................o.........o
ooooo.....o..o....o..o....o...o....oo.o.
......o................o...o..o.....o...
.......o..............o.o..o.....o...o..
.....oo.o.ooo....oo...............o.....
..o......o...o......oo.....oooo.......o.
....o...........o......o.o..o...oo.o....
.o..oo.o...o...o.....oo..o....ooo.......
o.....o.o.o.o..ooo....o.................
...o......oo......o...o........o...o..oo
..oo..............o.o.......o......o...o
.........oo......o.....o.o.........oo.o.
.o.........o...............o..o.......o.
.........o....o.o.....oo..........o..o..
....o......o......o......o.o..o.........
....o....o.............o.......oo..o...o
o....o..o.oo.....oo......oo.............
o.......o.o...o..o.o.o..............o.o.
...........o.......oo.o.............o...
.....o.........o........o.ooo.o.........
.............o.oo...oo........o.o.......
.......o..............o........oo...o..o
..o........o.....o.oo.....o..o.o.o......
.o..........o....o.oo...........o...o.o.
o.o...........o.........o..o..o.....o...
..o......o.o.....o...........o...o...o..
..........o...o.o............o.........o
........o..oooo..o...o.....o.....o..oo.o
