20.ox
....o...o.o......o..
....o....o......o..o
...o..o...........o.
o.....o..o..ooo..o..
o.o.....o.oo........
ooo.oo..oooo......o.
....o...o.....o.ooo.
..o...o..o.........o
o..o....oooo.o..o...
.o.............o....
...............o.o..
.o..o..oo...........
........o....o..o...
....o.o...o...o..o..
.o..o..o..o.o.......
............o.o.....
..........o..o......
oo....o...o.oo.o..o.
.o...oo...o.o..o...o
...o...oo.o......o.o
